NO ../../map/bluestone.png
SO ../../map/bluestone.png
WE ../../map/bluestone.png
EA ../../map/bluestone.png

F 220,100,0
C 225,30,0

11111111
10000001
10000001
100S0001
10000001
10000101
10000101
11111111