NO ../../map/bluestone.png
SO ../../map/bluestone.png
WE ../../map/bluestone.png
EA ../../map/bluestone.png

F 220,100,0
C 225,30,0

        11111111111111
        10000000000001
        10000000000001
        10000000000001
1111111110000000000001
1000000010111111111111
1111110101
1111011111111011101
110000001101010111
10000S000001
11111111 1111111 11111