NO        ./map/bluestone.xpm
SO ./map/greystone.xpm

WE ./map/purplestone.xpm

EA ./map/mossy.xpm

F 64,71,66

C 67,129,30



        1111111111111111111111111
        1000000000110000000000001
        1011000001110000000000001
        1001000000000000000000001
111111111011000001110000000000001
100000000011000001110111111111111
11110111111111011100000010001
1111011111111011101010010001
11000000110101011100000010001
1000010000000001100000010001
10001 1000N000001101010010001
1100010111010101111101111000111
11110111 1110101 101111010001
11111111 1111111 111111111111