NO ./map/bluestone.xpm
SO ./map/bluestone.xpm
WE ./map/bluestone.xpm
EA ./map/bluestone.xpm

F 220,100,0
C 225,30,0

111111111111111111
100000000000000011
10S010000000000011
100000000000000011
100000000100000011
100000000100000011
100100000001000011
100000001000000011
10000001 100000011
100000001000000011
100000000000010011
111111111111111111